########
#......#
#.P..E.#
#......#
#.B....#
########
